11111111111111111111111
1E0000000000000C00000C1
10100101001000001010011
10100000101010100000011
1P0001000C00C0000001001
100100010000100010001C1
101001001C1010100010011
1010C000101010100000011
10100101001000001010011
11111111111111111111111
